It's the afternoon and you are an ace detective working on another murder mystery. You have a partner who you can ask some questions about. The body was found dead in the alleyway and you must find out who the killer is. There are many clues to follow and no time to waste so get to work.

Murder Mystery
An Interactive Fiction by Aaron Hirahara
Release 1 / Serial number 170227 / Inform 7 build 6M62 (I6/v6.33 lib 6/12N) SD

alleyway
A big alley with gray brick walls on either side. The ground has a lot of cracks in the concrete. This is not the type of place you want to be spending your afternoon. To the south is the sidewalk.

You can see your partner and a dead body here.

I beg your pardon?

I beg your pardon?

* * *

>ask partner about body
There is no reply.

>ask partner about dead body
I like cheese

* * *

>ask partner about dead body
Someone phoned in about the dead body a whie ago. It's really starting to smell if you ask me.

* * *

>e
You can't go that way.

>n
sidewalk

>e
east sidewalk

>e
corner sidewalk

>e
You can't go that way.

>n
crosswalk

>n
night club entrance

>n
'night club'

>s
night club entrance

>w
apartment building entrance

>n
'apartment building'

* * *

>i
You are carrying nothing.

>x body
A blonde woman, maybe in her late 20"s.

you see that she is carrying a stamp card for the bakery next door.

>i
You are carrying:
  stamp card

>n
You can't go that way.

>s
sidewalk
An ordinary concrete sidewalk. Seems as if it has been repaved recently. To the west is the west part of the sidewalk to the east is the east part of the sidewalk, and to the north is the alleyway.

>w
west sidewalk
An ordinary concrete sidewalk. To the east is the sidewalk, to the west is the end of the sidewalk, and to the north is the bakery.

>n
bakery
As you enter the bakery you smell the aroma of fresh bread and see the baker kneading some dough.

You can see baker here.

>ask baker about Lisa
I heard about her death, she had so much to live for.

>ask baker about stamp card
There is no reply.

>ask baker about stamp
Yea, those are my stamp cards, buy 10 loafs get one for free. I remember seeing Lisa come into my shop a couple of hours ago to pre order a loaf of bread with one of those stamp cards. Then she said she was going to go to the flower shop, which is just east of here. She never came back for her bread though, would you like it?

Please answer yes or no.

>yes
Here you go.

>eat bread
You feel like you will need this later

>i
You are carrying:
  bread
  stamp card

* * *

>n
sidewalk
An ordinary concrete sidewalk. Seems as if it has been repaved recently. To the west is the west part of the sidewalk and to the east is the east part of the sidewalk.

>e
east sidewalk

* * *

>n
night club entrance

>n
night club entrance

* * *

>e
corner sidewalk

>n
crosswalk

>n
entrance to night club

>e
You can't go that way.

>w
entrance to apartment building

* * *

>e
east sidewalk

>s
flower shop

>n
east sidewalk

>e
corner sidewalk

>s
jewlery store

>n
corner sidewalk

>n
crosswalk

* * *

>n
entrance to night club

>n
entrance to night club

* * *

>e
east sidewalk

>w
east sidewalk

>w
You can't go that way.

* * *

>n
sidewalk
An ordinary concrete sidewalk. Seems as if it has been repaved recently. To the west is the west part of the sidewalk and to the east is the east part of the sidewalk.

>s
Alleyway
You can see a dead body here.

>n
sidewalk

* * *

>n
sidewalk
An ordinary concrete sidewalk. Seems as if it has been repaved recently. To the west is the west part of the sidewalk and to the east is the east part of the sidewalk.

>w
west sidewalk
An ordinary concrete sidewalk. To the east is the sidewalk, to the west is the end of the sidewalk, and to the south is the bakery.

>s
bakery
As you enter the bakery you smell the aroma of fresh bread and see the baker kneading some dough.

>n
west sidewalk

>w
end of sidewalk

>s
abandoned building

* * *

>w
west sidewalk
An ordinary concrete sidewalk. To the east is the sidewalk, to the west is the end of the sidewalk, and to the south is the bakery.

>w
end of sidewalk
An ordinary concrete sidewalk. Thee is no reason to walk further west.

>e
west sidewalk
An ordinary concrete sidewalk. To the east is the sidewalk, to the west is the end of the sidewalk, and to the south is the bakery.

>e
sidewalk
An ordinary concrete sidewalk. Seems as if it has been repaved recently. To the west is the west part of the sidewalk and to the east is the east part of the sidewalk.

>e
east sidewalk
An ordinary concrete sidewalk. To the west is the sidewalk, to the east is the corner sidewalk, and to the south is the flower shop.

>e
corner sidewalk
An ordinary concrete sidewalk. The sidewalk leads to a crosswalk. To the west is the east sidewalk, to the south is the jewlery store, and to the north is the crosswalk.

* * *

>n
sidewalk
An ordinary concrete sidewalk. Seems as if it has been repaved recently. To the west is the west part of the sidewalk and to the east is the east part of the sidewalk.

>x sidewalk
You can't see any such thing.

* * *

>pick up dead body
The body is turning pale, I don't think it's a good idea to move evidence.

>s
sidewalk
An ordinary concrete sidewalk. Seems as if it has been repaved recently. To the west is the west part of the sidewalk, to the east is the east part of the sidewalk, and to the north is the alleyway.

>e
east sidewalk
An ordinary concrete sidewalk. To the west is the sidewalk, to the east is the corner sidewalk, and to the north is the flower shop.

>e
corner sidewalk
An ordinary concrete sidewalk. The sidewalk leads to a crosswalk. To the west is the east sidewalk, to the north is the jewlery store, and to the south is the crosswalk.

>s
crosswalk
A white and black striped crosswalk.

>s
night club entrance
A part of the sidewalk with velvet rope leading into the night club. To the west is the apartment building entrance. To the north is the crosswalk.

You can see bouncer here.

>w
apartment building entrance
A one-story building stands before you. To the south is the door to the apartment building. To the east is the night club entrance.

You can see apartment entrance door here.

>w
You take a couple steps, but decide there is nothing important this way and turn back.

>e
night club entrance
A part of the sidewalk with velvet rope leading into the night club. To the west is the apartment building entrance. To the north is the crosswalk.

You can see bouncer here.

>e
You can't go that way.

>n
crosswalk
A white and black striped crosswalk.

>n
corner sidewalk
An ordinary concrete sidewalk. The sidewalk leads to a crosswalk. To the west is the east sidewalk, to the north is the jewlery store, and to the south is the crosswalk.

>n
jewelry store
You can see jeweler here.

>x jewelery store
You can't see any such thing.

>s
corner sidewalk
An ordinary concrete sidewalk. The sidewalk leads to a crosswalk. To the west is the east sidewalk, to the north is the jewlery store, and to the south is the crosswalk.

>w
east sidewalk
An ordinary concrete sidewalk. To the west is the sidewalk, to the east is the corner sidewalk, and to the north is the flower shop.

>n
flower shop
There are many different types of flowers in here. The aroma from the flowers give you the feeling of a fresh new beginning. You see all kinds of different flowers, like tulips and roses. To the south is the east sidewalk.

You can see florist here.

>s
east sidewalk
An ordinary concrete sidewalk. To the west is the sidewalk, to the east is the corner sidewalk, and to the north is the flower shop.

>e
corner sidewalk
An ordinary concrete sidewalk. The sidewalk leads to a crosswalk. To the west is the east sidewalk, to the north is the jewlery store, and to the south is the crosswalk.

>n
jewelry store
You can see jeweler here.

* * *

>pickup dead body
That's not a verb I recognise.

>take dead body
That's fixed in place.

* * *

>s
sidewalk
An ordinary concrete sidewalk. Seems as if it has been repaved recently. To the west is the west part of the sidewalk, to the east is the east part of the sidewalk, and to the north is the alleyway.

>e
You feel like you should still look around here for more clues.

>n
Alleyway
A big alley with gray brick walls on either side. The ground has a lot of cracks in the concrete. This is not the type of place you want to be spending your afternoon. To the south is the sidewalk.

You can see your partner and a dead body here.

>x dead body
A woman, maybe in her late 20"s.

you see that she is carrying a loaf of bread.

>take bread
Taken.

>s
sidewalk
An ordinary concrete sidewalk. Seems as if it has been repaved recently. To the west is the west part of the sidewalk to the east is the east part of the sidewalk, and to the north is the alleyway.

>e
east sidewalk
An ordinary concrete sidewalk. To the west is the sidewalk, to the east is the corner sidewalk, and to the north is the flower shop.

* * *

>e
You feel like you should still look around here for more clues.

>s
You can't go that way.

>n
flower shop
There are many different types of flowers in here. The aroma from the flowers give you the feeling of a fresh beginning.

You can see florist here.

>s
east sidewalk
An ordinary concrete sidewalk. To the west is the sidewalk, to the east is the corner sidewalk, and to the north is the flower shop.

>n
flower shop
There are many different types of flowers in here. The aroma from the flowers give you the feeling of a fresh beginning.

You can see florist here.

>ask florist about flower
Sure, I have lots of flowers, I'll give you one for free.

>i
You are carrying:
  flower

* * *

>s
sidewalk
An ordinary concrete sidewalk. Seems as if it has been repaved recently. To the west is the west part of the sidewalk, to the east is the east part of the sidewalk, and to the north is the alleyway.

>n
sidewalk

* * *

>s
sidewalk
An ordinary concrete sidewalk. Seems as if it has been repaved recently. To the west is the west part of the sidewalk, to the east is the east part of the sidewalk, and to the north is the alleyway.

>w
west sidewalk
An ordinary concrete sidewalk. To the east is the sidewalk, to the west is the end of the sidewalk, and to the north is the bakery.

I beg your pardon?

* * *

>w
west sidewalk
An ordinary concrete sidewalk. To the east is the sidewalk, to the west is the end of the sidewalk, and to the north is the bakery.

>e
sidewalk
An ordinary concrete sidewalk. Seems as if it has been repaved recently. To the west is the west part of the sidewalk, to the east is the east part of the sidewalk, and to the north is the alleyway.

>e
east sidewalk
An ordinary concrete sidewalk. To the west is the sidewalk, to the east is the corner sidewalk, and to the north is the flower shop.

* * *

>e
corner sidewalk
An ordinary concrete sidewalk. The sidewalk leads to a crosswalk. To the west is the east sidewalk, to the north is the jewlery store, and to the south is the crosswalk.

>n
jewelry store
A fancy store with glass casing covering all the jewelry. There is no store entrance window, probably so thieves cannot case the inside of the building. To the south is the corner sidewalk.

You can see jeweler here.

>n
You can't go that way.

>s
corner sidewalk
An ordinary concrete sidewalk. The sidewalk leads to a crosswalk. To the west is the east sidewalk, to the north is the jewlery store, and to the south is the crosswalk.

* * *

>w
east sidewalk
An ordinary concrete sidewalk. To the west is the sidewalk, to the east is the corner sidewalk, and to the north is the flower shop.

>w
sidewalk
An ordinary concrete sidewalk. Seems as if it has been repaved recently. To the west is the west part of the sidewalk, to the east is the east part of the sidewalk, and to the north is the alleyway.

>w
west sidewalk
An ordinary concrete sidewalk. To the east is the sidewalk, to the west is the end of the sidewalk, and to the north is the bakery.

>n
bakery
As you enter the bakery you smell the aroma of fresh bread and see the baker kneading some dough. A glass window is in the front of the store and there is a showcase of different breads in the back of the bakery. There are also other pastries in rows in the storefront window. To the south is the west sidewalk.

You can see baker here.

>s
west sidewalk
An ordinary concrete sidewalk. To the east is the sidewalk, to the west is the end of the sidewalk, and to the north is the bakery.

>w
You take a couple steps, but decide there is nothing important this way and turn back.

>e
sidewalk
An ordinary concrete sidewalk. Seems as if it has been repaved recently. To the west is the west part of the sidewalk, to the east is the east part of the sidewalk, and to the north is the alleyway.

* * *

>e
corner sidewalk
An ordinary concrete sidewalk. The sidewalk leads to a crosswalk. To the west is the east sidewalk, to the north is the jewlery store, and to the south is the crosswalk.

>e
You take a couple steps, but decide there is nothing important this way and turn back.

>s
crosswalk
A white and black striped crosswalk.

* * *

>w
apartment building entrance
A one-story building stands before you. To the south is the door to the apartment building. To the east is the night club entrance.

You can see apartment entrance door here.

>e
night club entrance
A part of the sidewalk with velvet rope leading into the night club. To the west is the apartment building entrance. To the north is the crosswalk.

You can see bouncer here.

>n
crosswalk
A white and black striped crosswalk.

* * *

>n
corner sidewalk
An ordinary concrete sidewalk. The sidewalk leads to a crosswalk. To the west is the east sidewalk, to the north is the jewlery store, and to the south is the crosswalk.

>w
east sidewalk
An ordinary concrete sidewalk. To the west is the sidewalk, to the east is the corner sidewalk, and to the north is the flower shop.

* * *

>n
flower shop
There are many different types of flowers in here. The aroma from the flowers give you the feeling of a fresh new beginning. You see all kinds of different flowers, like tulips and roses. To the south is the east sidewalk.

You can see florist here.

>ask florist about flower
Sure, I have lots of flowers, I'll give you one for free.

>s
east sidewalk
An ordinary concrete sidewalk. To the west is the sidewalk, to the east is the corner sidewalk, and to the north is the flower shop.

>w
sidewalk
An ordinary concrete sidewalk. Seems as if it has been repaved recently. To the west is the west part of the sidewalk, to the east is the east part of the sidewalk, and to the north is the alleyway.

* * *

>n
bakery
As you enter the bakery you smell the aroma of fresh bread and see the baker kneading some dough. A glass window is in the front of the store and there is a showcase of different breads in the back of the bakery. There are also other pastries in rows in the storefront window. To the south is the west sidewalk.

You can see baker here.

>ask baker about stamp card
Yea, those are my stamp cards, buy 10 loafs get one for free. I remember seeing Lisa come into my shop a couple of hours ago to pre order a loaf of bread with one of those stamp cards. Then she said she was going to go to the flower shop, which is just east of here. She never came back for her bread though, would you like it?

>yes
Here you go.

>w
You can't go that way.

>n
You can't go that way.

>s
west sidewalk
An ordinary concrete sidewalk. To the east is the sidewalk, to the west is the end of the sidewalk, and to the north is the bakery.

>e
sidewalk
An ordinary concrete sidewalk. Seems as if it has been repaved recently. To the west is the west part of the sidewalk, to the east is the east part of the sidewalk, and to the north is the alleyway.

* * *

>s
night club entrance
A part of the sidewalk with velvet rope leading into the night club. To the west is the apartment building entrance. To the north is the crosswalk.

You can see bouncer here.

>give bouncer bread
Thank you for the bread. I am really hungry right now, but I have to guard this entrance, so I was not able to get any food. You are a real lifesaver.

>give bouncer flowers
Thank you, I really wanted a flower because I have been so sad recently. This really helps my suit stand out, he puts the flower in his breast pocket. No one really likes me because I seem scary, but deep down I am a nice guy.

>s
night club
Since it is not night, there is no one in the night club at the moment. You see a bar and a row of seats. It is kind of dark in the night club because normally the lights are on. To the north is the night club entrance.

You can see chairs and a bar here.

>x chairs
Ordinary charis next to the bar.

I beg your pardon?

>take all
There are none at all available!

>x bar
A marble bar supported by a slab of wood. On one side there is a row of chairs, on the other side you see shelves.

>take bar
That's fixed in place.

>x shelves
You notice something glimmer behind one of the liquor bottles and move it. You find a key and decide to put it in your pocket.

>n
night club entrance
A part of the sidewalk with velvet rope leading into the night club. To the west is the apartment building entrance. To the north is the crosswalk.

You can see bouncer here.

>w
apartment building entrance
A one-story building stands before you. To the south is the door to the apartment building. To the east is the night club entrance.

You can see apartment entrance door here.

>open door with key
You unlock apartment entrance door.

>s
(first opening apartment entrance door)

apartment building
An apartment with no security. There is a hall with rooms on either side. To the north is the apartment entrance. To the west is room 101.

You can see apartment entrance door here.

>w
You jiggle the door knob and realize that the door is unlocked. Without thinking twice, you shove the door open.

Room 101
An ordinary room which looks like it has been flipped upside down. There is blood splattered along the floor. To the east is the apartment hall.

You can see knife here.

>take knife
Taken.

>s
You can't go that way.

>e
apartment building
An apartment with no security. There is a hall with rooms on either side. To the north is the apartment entrance. To the west is room 101.

You can see apartment entrance door here.

>e
You can't go that way.

>w
You jiggle the door knob and realize that the door is unlocked. Without thinking twice, you shove the door open.

Room 101
An ordinary room which looks like it has been flipped upside down. There is blood splattered along the floor. To the east is the apartment hall.

>e
apartment building
An apartment with no security. There is a hall with rooms on either side. To the north is the apartment entrance. To the west is room 101.

You can see apartment entrance door here.

>n
apartment building entrance
A one-story building stands before you. To the south is the door to the apartment building. To the east is the night club entrance.

You can see apartment entrance door here.

>s
apartment building
An apartment with no security. There is a hall with rooms on either side. To the north is the apartment entrance. To the west is room 101.

You can see apartment entrance door here.

>n
apartment building entrance
A one-story building stands before you. To the south is the door to the apartment building. To the east is the night club entrance.

You can see apartment entrance door here.

>e
night club entrance
A part of the sidewalk with velvet rope leading into the night club. To the west is the apartment building entrance. To the north is the crosswalk.

You can see bouncer here.

>s
night club
Since it is not night, there is no one in the night club at the moment. You see a bar and a row of seats. It is kind of dark in the night club because normally the lights are on. To the north is the night club entrance.

You can see chairs and a bar here.

>s
You can't go that way.

>s
You can't go that way.

>n
night club entrance
A part of the sidewalk with velvet rope leading into the night club. To the west is the apartment building entrance. To the north is the crosswalk.

You can see bouncer here.

>s
night club
Since it is not night, there is no one in the night club at the moment. You see a bar and a row of seats. It is kind of dark in the night club because normally the lights are on. To the north is the night club entrance.

You can see chairs and a bar here.

* * *

>n
night club entrance
A part of the sidewalk with velvet rope leading into the night club. To the west is the apartment building entrance. To the north is the crosswalk.

You can see bouncer here.

>n
crosswalk
A white and black striped crosswalk.

* * *

>n
corner sidewalk
An ordinary concrete sidewalk. The sidewalk leads to a crosswalk. To the west is the east sidewalk, to the north is the jewlery store, and to the south is the crosswalk.

>n
jewelry store
A fancy store with glass casing covering all the jewelry. There is no store entrance window, probably so thieves cannot case the inside of the building. To the south is the corner sidewalk.

You can see jeweler here.

>ask jeweler about knife
How did you find that? Okay, I'll talk. Just try to cut me a deal if I confess, okay?

precinct
You take the jeweler down to the precinct to interrogate him. He confesses to the murder of Lisa and says he was just really angry. He murdered her in her room and then dumped the body in the alleyway. He says she didn't know what was best for herself.... Just another day in the life of an ace detective.

    *** The End ***

Would you like to RESTART, RESTORE a saved game, QUIT or UNDO the last command?

>undo
jewelry store
[Previous turn undone.]

>s
corner sidewalk
An ordinary concrete sidewalk. The sidewalk leads to a crosswalk. To the west is the east sidewalk, to the north is the jewlery store, and to the south is the crosswalk.

>s
crosswalk
A white and black striped crosswalk.

* * *

>s
night club entrance
A part of the sidewalk with velvet rope leading into the night club. To the west is the apartment building entrance. To the north is the crosswalk.

You can see bouncer here.

>s
night club
Since it is not night, there is no one in the night club at the moment. You see a bar and a row of seats. It is kind of dark in the night club because normally the lights are on. To the north is the night club entrance.

You can see chairs and a bar here.

>sit in chair
You get onto chairs.

>north
(first getting off chairs)

night club entrance
A part of the sidewalk with velvet rope leading into the night club. To the west is the apartment building entrance. To the north is the crosswalk.

You can see bouncer here.

* * *

>n
bakery
As you enter the bakery you smell the aroma of fresh bread and see the baker kneading some dough. A glass window is in the front of the store and there is a showcase of different breads in the back of the bakery. There are also other pastries in rows in the storefront window. To the south is the west sidewalk.

You can see baker here.

>ask baker about stamp
I remember seeing her come into my shop a couple of hours ago to pre order a loaf of bread. Then she said she was on her way to the flower shop, which is just east of here. She never came back for her bread though, would you like it?

* * *

>n
bakery
As you enter the bakery you smell the aroma of fresh bread and see the baker kneading some dough. A glass window is in the front of the store and there is a showcase of different breads in the back of the bakery. There are also other pastries in rows in the storefront window. To the south is the west sidewalk.

You can see baker here.

>s
west sidewalk
An ordinary concrete sidewalk. To the east is the sidewalk, to the west is the end of the sidewalk, and to the south is the bakery.

>w
end of sidewalk
An ordinary concrete sidewalk. Thee is no reason to walk further west.

>n
abandoned building

>s
end of sidewalk
An ordinary concrete sidewalk. Thee is no reason to walk further west.

>w
You can't go that way.

>e
west sidewalk
An ordinary concrete sidewalk. To the east is the sidewalk, to the west is the end of the sidewalk, and to the south is the bakery.

>e
sidewalk
An ordinary concrete sidewalk. Seems as if it has been repaved recently. To the west is the west part of the sidewalk to the east is the east part of the sidewalk, and to the north is the alleyway.

>e
east sidewalk
An ordinary concrete sidewalk. To the west is the sidewalk, to the east is the corner sidewalk, and to the south is the flower shop.

>n
flower shop

>s
east sidewalk
An ordinary concrete sidewalk. To the west is the sidewalk, to the east is the corner sidewalk, and to the south is the flower shop.

>e
corner sidewalk
An ordinary concrete sidewalk. The sidewalk leads to a crosswalk. To the west is the east sidewalk, to the south is the jewlery store, and to the north is the crosswalk.

>n
jewelry store

>s
corner sidewalk
An ordinary concrete sidewalk. The sidewalk leads to a crosswalk. To the west is the east sidewalk, to the south is the jewlery store, and to the north is the crosswalk.

>s
crosswalk
A white and black striped crosswalk.

>s
night club entrance
You can see bouncer here.

>s
night club entrance
You can see bouncer here.

* * *

>n
bakery
As you enter the bakery you smell the aroma of fresh bread and see the baker kneading some dough. A glass window is in the front of the store and there is a showcase of different breads in the back of the bakery. There are also other pastries in rows in the storefront window. To the south is the west sidewalk.

You can see baker here.

>x pastries
A variety of different delicacies. All which look very delicious.

>take pastries
You are on duty, maybe after you solve the case.

* * *

>n
bakery
As you enter the bakery you smell the aroma of fresh bread and see the baker kneading some dough. A glass window is in the front of the store and there is a showcase of different breads in the back of the bakery. There are also other pastries in rows in the storefront window. To the south is the west sidewalk.

You can see baker here.

>x squirrel
You can't see any such thing.

* * *

>w
west sidewalk
An ordinary concrete sidewalk. To the east is the sidewalk, to the west is the end of the sidewalk, and to the north is the bakery.

>w
end of sidewalk
An ordinary concrete sidewalk. Thee is no reason to walk further west.

>w
You take a couple steps, but decide there is nothing important this way and turn back.

>w
sidewalk

>w
sidewalk

>e
sidewalk

>e
sidewalk

>s
You can't go that way.

>n
Alleyway
You can see a dead body here.

* * *

>w
sidewalk

I beg your pardon?

>w
sidewalk

* * *

>south
sidewalk

>north
Bakery

>north
You can't go that way.

>south
sidewalk

* * *

>north
Bakery

>south
sidewalk

>south
You can't go that way.

* * *

>north
Bakery

>west
Alleyway

* * *

>take all
There are none at all available!

>w
You can't go that way.

>s
sidewalk
An ordinary concrete sidewalk. Seems as if it has been repaved recently. To the west is the west part of the sidewalk to the east is the east part of the sidewalk, and to the north is the alleyway.

>take all
You can't see any such thing.

>w
west sidewalk
An ordinary concrete sidewalk. To the east is the sidewalk, to the west is the end of the sidewalk, and to the north is the bakery.

* * *

>n
bakery
As you enter the bakery you smell the aroma of fresh bread and see the baker kneading some dough.

You can see baker here.

>ask baker about dead body
I heard about the women's death, her name was Lisa right? She had so much to live for.

* * *

>take flower
You can't see any such thing.

>west
You can't go that way.

>e
You can't go that way.

>s
sidewalk
An ordinary concrete sidewalk. Seems as if it has been repaved recently. To the west is the west part of the sidewalk to the east is the east part of the sidewalk, and to the north is the alleyway.

* * *

>talk to partner
That's not a verb I recognise.

>ask partner
What do you want to ask your partner for?

* * *

>talk to partner
That's not a verb I recognise.

>ask partner about dead body
Someone phoned in about the dead body a little while ago and we learned that the victim's name is Lisa.

>ask partner about lisa
Ohhh, so that's the victims name. I'll make sure to jot that down.

>i
You are carrying nothing.

>s
sidewalk
An ordinary concrete sidewalk. Seems as if it has been repaved recently. To the west is the west part of the sidewalk to the east is the east part of the sidewalk, and to the north is the alleyway.

>e
east sidewalk
An ordinary concrete sidewalk. TheTo the west is the sidewalk, to the east is the corner sidewalk, and to the north is the flower shop.

>n
flower shop
There are many different types of flowers in here. The aroma from the flowers give you the feeling of a fresh new beginning. You see all kinds of different flowers, like tulips and roses. To the south is the east sidewalk.

You can see florist here.

>ask florist about lisa
I saw her come in the other day, she just browsed around my shop for a little while and then went on her way. I think she works as a bartender in the night club.

>ask florist about flowers
Sure, I have lots of flowers, I'll give you one for free.

>s
east sidewalk
An ordinary concrete sidewalk. TheTo the west is the sidewalk, to the east is the corner sidewalk, and to the north is the flower shop.

>e
corner sidewalk
An ordinary concrete sidewalk. The sidewalk leads to a crosswalk. To the west is the east sidewalk, to the north is the jewlery store, and to the south is the crosswalk.

* * *

>n
jewelry store
You can see jeweler here.

>x jewler
You can't see any such thing.

>x jeweler
A man in a suit wearing a monocle. You can try asking him some questions, but he doesn't see that chatty.

>take monocle
You can't see any such thing.

>ask jeweler about monocle
There is no reply.

>ask jeweler about lisa
I don't have to talk to you. If you are not a customer I do not want you in my store. Please leave.

>ask jeweler about jewels
There is no reply.

>s
corner sidewalk
An ordinary concrete sidewalk. The sidewalk leads to a crosswalk. To the west is the east sidewalk, to the north is the jewlery store, and to the south is the crosswalk.

>w
east sidewalk
An ordinary concrete sidewalk. TheTo the west is the sidewalk, to the east is the corner sidewalk, and to the north is the flower shop.

>e
corner sidewalk
An ordinary concrete sidewalk. The sidewalk leads to a crosswalk. To the west is the east sidewalk, to the north is the jewlery store, and to the south is the crosswalk.

>w
east sidewalk
An ordinary concrete sidewalk. TheTo the west is the sidewalk, to the east is the corner sidewalk, and to the north is the flower shop.

* * *

>s
crosswalk
A white and black striped crosswalk.

>x crosswalk
You can't see any such thing.

>s
night club entrance
A part of the sidewalk with velvet rope leading into the night club. To the west is the apartment building entrance. To the north is the crosswalk.

You can see bouncer here.

>ask bouncer about lisa
She worked for this night club, she was the bartender and lived next door. Are you saying she was the one killed? That's horrible.

>ask bouncer about bouncing
There is no reply.

>s
The bouncer blocks your path. He seems kind of sad, maybe you could give him some things to cheer him up, so he will let you pass. Maybe something to eat and something that smells nice.

>give bouncer flower
Thank you, I really wanted a flower because I have been so sad recently. This really helps my suit stand out, he puts the flower in his breast pocket. No one really likes me because I seem scary, but deep down I am a nice guy.

>s
The bouncer blocks your path. He seems kind of sad, maybe you could give him some things to cheer him up, so he will let you pass. Maybe something to eat and something that smells nice.

>w
apartment building entrance
A one-story building stands before you. To the south is the door to the apartment building. To the east is the night club entrance.

You can see apartment entrance door here.

>open door
It seems to be locked.

>e
night club entrance
A part of the sidewalk with velvet rope leading into the night club. To the west is the apartment building entrance. To the north is the crosswalk.

You can see bouncer here.

>w
apartment building entrance
A one-story building stands before you. To the south is the door to the apartment building. To the east is the night club entrance.

You can see apartment entrance door here.

>s
(first opening apartment entrance door)
It seems to be locked.

>e
night club entrance
A part of the sidewalk with velvet rope leading into the night club. To the west is the apartment building entrance. To the north is the crosswalk.

You can see bouncer here.

* * *

>n
corner sidewalk
An ordinary concrete sidewalk. The sidewalk leads to a crosswalk. To the west is the east sidewalk, to the north is the jewlery store, and to the south is the crosswalk.

>s
crosswalk
A white and black striped crosswalk.

>n
corner sidewalk
An ordinary concrete sidewalk. The sidewalk leads to a crosswalk. To the west is the east sidewalk, to the north is the jewlery store, and to the south is the crosswalk.

>w
east sidewalk
An ordinary concrete sidewalk. TheTo the west is the sidewalk, to the east is the corner sidewalk, and to the north is the flower shop.

>w
sidewalk
An ordinary concrete sidewalk. Seems as if it has been repaved recently. To the west is the west part of the sidewalk to the east is the east part of the sidewalk, and to the north is the alleyway.

>w
west sidewalk
An ordinary concrete sidewalk. To the east is the sidewalk, to the west is the end of the sidewalk, and to the north is the bakery.

* * *

>n
bakery
As you enter the bakery you smell the aroma of fresh bread and see the baker kneading some dough. A glass window is in the front of the store and there is a showcase of different breads in the back of the bakery. There are also other pastries in rows in the storefront window. To the south is the west sidewalk.

You can see baker here.

>ask baker about dough
There is no reply.

>ask baker about bread
There is no reply.

>ask baker about fresh bread
There is no reply.

>ask baker about lisa
I heard about her death, she had so much to live for.

>ask baker about pastires
There is no reply.

>ask baker about bakery
There is no reply.

>ask baker about bouncer
There is no reply.

>ask baker about food
There is no reply.

>s
west sidewalk
An ordinary concrete sidewalk. To the east is the sidewalk, to the west is the end of the sidewalk, and to the north is the bakery.

>e
sidewalk
An ordinary concrete sidewalk. Seems as if it has been repaved recently. To the west is the west part of the sidewalk to the east is the east part of the sidewalk, and to the north is the alleyway.

>n
alleyway
A big alley with gray brick walls on either side. The ground has a lot of cracks in the concrete. This is not the type of place you want to be spending your afternoon. To the south is the sidewalk.

You can see your partner and a dead body here.

>s
sidewalk
An ordinary concrete sidewalk. Seems as if it has been repaved recently. To the west is the west part of the sidewalk to the east is the east part of the sidewalk, and to the north is the alleyway.

* * *

>n
flower shop
There are many different types of flowers in here. The aroma from the flowers give you the feeling of a fresh new beginning. You see all kinds of different flowers, like tulips and roses. To the south is the east sidewalk.

You can see florist here.

>s
east sidewalk
An ordinary concrete sidewalk. TheTo the west is the sidewalk, to the east is the corner sidewalk, and to the north is the flower shop.

* * *

>n
jewelry store
You can see jeweler here.

>s
corner sidewalk
An ordinary concrete sidewalk. The sidewalk leads to a crosswalk. To the west is the east sidewalk, to the north is the jewlery store, and to the south is the crosswalk.

>e
You take a couple steps, but decide there is nothing important this way and turn back.

>e
You take a couple steps, but decide there is nothing important this way and turn back.

* * *

I beg your pardon?

>w
east sidewalk
An ordinary concrete sidewalk. TheTo the west is the sidewalk, to the east is the corner sidewalk, and to the north is the flower shop.

>n
flower shop
There are many different types of flowers in here. The aroma from the flowers give you the feeling of a fresh new beginning. You see all kinds of different flowers, like tulips and roses. To the south is the east sidewalk.

You can see florist here.

* * *

>ask florist about lisa
I saw her come in the other day, she just browsed around my shop for a little while and then went on her way. I think she works as a bartender in the night club.

>s
east sidewalk
An ordinary concrete sidewalk. TheTo the west is the sidewalk, to the east is the corner sidewalk, and to the north is the flower shop.

>w
sidewalk
An ordinary concrete sidewalk. Seems as if it has been repaved recently. To the west is the west part of the sidewalk to the east is the east part of the sidewalk, and to the north is the alleyway.

>e
east sidewalk
An ordinary concrete sidewalk. TheTo the west is the sidewalk, to the east is the corner sidewalk, and to the north is the flower shop.

>w
sidewalk
An ordinary concrete sidewalk. Seems as if it has been repaved recently. To the west is the west part of the sidewalk to the east is the east part of the sidewalk, and to the north is the alleyway.

* * *

>w
west sidewalk
An ordinary concrete sidewalk. To the east is the sidewalk, to the west is the end of the sidewalk, and to the north is the bakery.

>e
sidewalk
An ordinary concrete sidewalk. Seems as if it has been repaved recently. To the west is the west part of the sidewalk to the east is the east part of the sidewalk, and to the north is the alleyway.

>e
east sidewalk
An ordinary concrete sidewalk. TheTo the west is the sidewalk, to the east is the corner sidewalk, and to the north is the flower shop.

>e
corner sidewalk
An ordinary concrete sidewalk. The sidewalk leads to a crosswalk. To the west is the east sidewalk, to the north is the jewlery store, and to the south is the crosswalk.

* * *

>s
night club entrance
A part of the sidewalk with velvet rope leading into the night club. To the west is the apartment building entrance. To the north is the crosswalk.

You can see bouncer here.

>s
The bouncer blocks your path. He seems kind of sad, maybe you could give him some things to cheer him up, so he will let you pass. Maybe something to eat and something that smells nice.

>n
crosswalk
A white and black striped crosswalk.

* * *

>n
corner sidewalk
An ordinary concrete sidewalk. The sidewalk leads to a crosswalk. To the west is the east sidewalk, to the north is the jewlery store, and to the south is the crosswalk.

>e
You take a couple steps, but decide there is nothing important this way and turn back.

>w
east sidewalk
An ordinary concrete sidewalk. TheTo the west is the sidewalk, to the east is the corner sidewalk, and to the north is the flower shop.

* * *

>n
bakery
As you enter the bakery you smell the aroma of fresh bread and see the baker kneading some dough. A glass window is in the front of the store and there is a showcase of different breads in the back of the bakery. There are also other pastries in rows in the storefront window. To the south is the west sidewalk.

You can see baker here.

>x bakery
You can't see any such thing.

>take all
There are none at all available!

>take bread
You can't see any such thing.

>s
west sidewalk
An ordinary concrete sidewalk. To the east is the sidewalk, to the west is the end of the sidewalk, and to the north is the bakery.

>n
bakery
As you enter the bakery you smell the aroma of fresh bread and see the baker kneading some dough. A glass window is in the front of the store and there is a showcase of different breads in the back of the bakery. There are also other pastries in rows in the storefront window. To the south is the west sidewalk.

You can see baker here.

* * *

>n
alleyway
A big alley with gray brick walls on either side. The ground has a lot of cracks in the concrete. This is not the type of place you want to be spending your afternoon. To the south is the sidewalk.

You can see your partner and a dead body here.

>x dead body]
I only understood you as far as wanting to examine the dead body.

>x dead body
A blonde woman, maybe in her late 20"s.

you see that she is carrying a stamp card from the bakery next door.

>take stamp
Taken.

>s
sidewalk
An ordinary concrete sidewalk. Seems as if it has been repaved recently. To the west is the west part of the sidewalk to the east is the east part of the sidewalk, and to the north is the alleyway.

* * *

>n
bakery
As you enter the bakery you smell the aroma of fresh bread and see the baker kneading some dough. A glass window is in the front of the store and there is a showcase of different breads in the back of the bakery. There are also other pastries in rows in the storefront window. To the south is the west sidewalk.

You can see baker here.

>ask baker about card
Yea, those are my stamp cards, buy 10 loafs get one for free. I remember seeing Lisa come into my shop a couple of hours ago to pre order a loaf of bread with one of those stamp cards. Then she said she was going to go to the flower shop, which is just east of here. She never came back for her bread though, would you like it?

Please answer yes or no.

* * *

>w
You can't go that way.

* * *

>n
bakery
As you enter the bakery you smell the aroma of fresh bread and see the baker kneading some dough.

You can see baker here.

>ask baker about stamp
Yea, those are my stamp cards, buy 10 loafs get one for free. I remember seeing Lisa come into my shop a couple of hours ago to pre order a loaf of bread with one of those stamp cards. Then she said she was going to go to the flower shop, which is just east of here. She never came back for her bread though, would you like it?

>yes
Here you go.

>i
You are carrying:
  bread

>s
west sidewalk
An ordinary concrete sidewalk. To the east is the sidewalk, to the west is the end of the sidewalk, and to the north is the bakery.

>w
end of sidewalk
An ordinary concrete sidewalk. Thee is no reason to walk further west.

>e
west sidewalk
An ordinary concrete sidewalk. To the east is the sidewalk, to the west is the end of the sidewalk, and to the north is the bakery.

>e
sidewalk
An ordinary concrete sidewalk. Seems as if it has been repaved recently. To the west is the west part of the sidewalk to the east is the east part of the sidewalk, and to the north is the alleyway.

>e
east sidewalk
An ordinary concrete sidewalk. To the west is the sidewalk, to the east is the corner sidewalk, and to the north is the flower shop.

* * *

>x alleyway
You can't see any such thing.

>n
You can't go that way.

>e
You can't go that way.

>s
You can't go that way.

>w
You can't go that way.

* * *

>x body
A blonde woman, maybe in her late 20"s.

you see that she is carrying a stamp card from the bakery next door.

>take stamp
Taken.

>i
You are carrying:
  stamp card

* * *

>w
west sidewalk
An ordinary concrete sidewalk. To the east is the sidewalk, to the west is the end of the sidewalk, and to the north is the bakery.

>n
bakery
As you enter the bakery you smell the aroma of fresh bread and see the baker kneading some dough. To the south is the west sidewalk.

You can see baker here.

>ask baker about stamp
Yea, those are my stamp cards, buy 10 loafs get one for free. I remember seeing Lisa come into my shop a couple of hours ago to pre order a loaf of bread with one of those stamp cards. Then she said she was going to go to the flower shop, which is just east of here. She never came back for her bread though, would you like it?

* * *

>yes
Here you go.

>s
west sidewalk
An ordinary concrete sidewalk. To the east is the sidewalk, to the west is the end of the sidewalk, and to the north is the bakery.

* * *

>e
east sidewalk
An ordinary concrete sidewalk. To the west is the sidewalk, to the east is the corner sidewalk, and to the north is the flower shop.

>n
flower shop
There are many different types of flowers in here. The aroma from the flowers give you the feeling of a fresh new beginning.

You can see florist here.

>ask florist about flower
Sure, I have lots of flowers, I'll give you one for free.

* * *

>give bouncer bread
Thank you for the bread. I am really hungry right now, but I have to guard this entrance, so I was not able to get any food. You are a real lifesaver.

>give bouncer flower
Thank you, I really wanted a flower because I have been so sad recently. This really helps my suit stand out, he puts the flower in his breast pocket. No one really likes me because I seem scary, but deep down I am a nice guy.

>s
night club
Since it is not night, there is no one in the night club at the moment. You see a bar and a row of seats. To the north is the night club entrance.

You can see a bar here.

>x bar
A marble bar supported by a slab of wood. On one side there is a row of chairs, on the other side you see shelves.

>x shelves
A row of shelves with liquor on them.

You notice something glimmer behind one of the liquor bottles and move it. You find a key and decide to put it in your pocket.

>n
night club entrance
A part of the sidewalk with velvet rope leading into the night club. To the west is the apartment building entrance. To the north is the crosswalk.

You can see bouncer here.

* * *

>open door
It seems to be locked.

>unlock door with key
You unlock apartment entrance door.

>s
(first opening apartment entrance door)

apartment building
An apartment with no security. There is a hall with rooms on either side. To the north is the apartment entrance. To the west is room 101.

You can see apartment entrance door here.

>west
You jiggle the door knob and realize that the door is unlocked. Without thinking twice you shove the door open.

Room 101
An ordinary room which looks like it has been flipped upside down. There is blood splattered along the floor. To the east is the apartment hall.

You can see knife here.

>take knife
Taken.

>n
You can't go that way.

>s
You can't go that way.

* * *

>e
night club entrance
A part of the sidewalk with velvet rope leading into the night club. To the west is the apartment building entrance. To the north is the crosswalk.

You can see bouncer here.

>s
night club
Since it is not night, there is no one in the night club at the moment. You see a bar and a row of seats. To the north is the night club entrance.

You can see a bar here.

>s
You can't go that way.

* * *

>n
jewelry store
You can see jeweler here.

>ask jeweler about knife
How did you find that? Okay, I'll talk. Just try to cut me a deal if I confess, okay?

presinct
You take the jeweler down to the presinct to interogate him. He confesses to the murder of Lisa and says he was doing it for love. He says she didn't know what was best for herself, so he had to take matters into his own hands... Just another day in the life of an ace detective.

    *** The End ***

Would you like to RESTART, RESTORE a saved game, QUIT or UNDO the last command?

* * *

>yes
Here you go.

>x baker
A man with a moustache wearning a chef's hat and a chef uniform. He is covered in flour. You can ask him about the dead body, Lisa, stamp card.

>n
You can't go that way.

>w
You can't go that way.

>e
You can't go that way.

>s
west sidewalk
An ordinary concrete sidewalk. To the east is the sidewalk, to the west is the end of the sidewalk, and to the north is the bakery.

* * *

>e
corner sidewalk
An ordinary concrete sidewalk. The sidewalk leads to a crosswalk. To the west is the east sidewalk, to the north is the jewlery store, and to the south is the crosswalk.

>w
east sidewalk
An ordinary concrete sidewalk. To the west is the sidewalk, to the east is the corner sidewalk, and to the north is the flower shop.

>n
flower shop
There are many different types of flowers in here. The aroma from the flowers give you the feeling of a fresh new beginning.

You can see florist here.

* * *

>ask florist about flower
Sure, I have lots of flowers, I'll give you one for free.

>x florist
A lady wearning a green apron with a long sleeved shirt, jeans, and glasses.

>s
east sidewalk
An ordinary concrete sidewalk. To the west is the sidewalk, to the east is the corner sidewalk, and to the north is the flower shop.

>w
sidewalk
An ordinary concrete sidewalk. Seems as if it has been repaved recently. To the west is the west part of the sidewalk to the east is the east part of the sidewalk, and to the north is the alleyway.

>e
east sidewalk
An ordinary concrete sidewalk. To the west is the sidewalk, to the east is the corner sidewalk, and to the north is the flower shop.

* * *

>s
night club entrance
A part of the sidewalk with velvet rope leading into the night club. To the west is the apartment building entrance. To the north is the crosswalk.

You can see bouncer here.

>give bouncer flower
Thank you, I really wanted a flower because I have been so sad recently. This really helps my suit stand out, he puts the flower in his breast pocket. No one really likes me because I seem scary, but deep down I am a nice guy.

>give bouncer bread
Thank you for the bread. I am really hungry right now, but I have to guard this entrance, so I was not able to get any food. You are a real lifesaver.

>s
night club
Since it is not night, there is no one in the night club at the moment. You see a bar and a row of seats. To the north is the night club entrance.

You can see a bar here.

* * *

>w
apartment building entrance
A one-story building stands before you. To the south is the door to the apartment building. To the east is the night club entrance.

You can see apartment entrance door here.

>open apartment door with key
You unlock apartment entrance door.

>s
(first opening apartment entrance door)

apartment building
An apartment with no security. There is a hall with rooms on either side. To the north is the apartment entrance. To the west is room 101.

You can see apartment entrance door here.

* * *

>n
You can't go that way.

>e
apartment building
An apartment with no security. There is a hall with rooms on either side. To the north is the apartment entrance. To the west is room 101.

You can see apartment entrance door here.

* * *

>ask jeweler about knife
How did you find that? Okay, I'll talk. Just try to cut me a deal if I confess, okay?

presinct
You take the jeweler down to the presinct to interogate him. He confesses to the murder of Lisa and says he was doing it for love. He says she didn't know what was best for herself, so he had to take matters into his own hands... Just another day in the life of an ace detective.

    *** The End ***

Would you like to RESTART, RESTORE a saved game, QUIT or UNDO the last command?

>resart
Please give one of the answers above.

Would you like to RESTART, RESTORE a saved game, QUIT or UNDO the last command?

* * *

>take stamp
Taken.

>x partner
A skinny man dressed exactly like you. You can ask him about the dead body, the shops, and some other things.

>ask partner about dead body
Someone phoned in about the dead body a little while ago, we have no idea who the culprit is.

>ask partner about the shops
There is no reply.

>ask partner about shop
There is no reply.

>ask partner about shops
There is no reply.

>ask partner about store
There is no reply.

>ask partner about bakery
I saw the shop; it is to the west of us.

>s
sidewalk
An ordinary concrete sidewalk. Seems as if it has been repaved recently. To the west is the west part of the sidewalk, to the east is the east part of the sidewalk, and to the north is the alleyway.

* * *

>n
bakery
As you enter the bakery you smell the aroma of fresh bread and see the baker kneading some dough. A glass window is in the front of the store and there is a showcase of different breads in the back of the bakery. There are also other pastries in rows in the storefront window. To the south is the west sidewalk.

You can see baker here.

>x pastries
You can't see any such thing.

>talk to baker
That's not a verb I recognise.

>x baker
A man with a moustache wearing a chef's hat and a chef uniform. He is covered in flour. You can ask him about the dead body, the shops, and a few other things.

>ask baker about dead body
I heard about the women's death, her name was Lisa right? She had so much to live for.

>s
west sidewalk
An ordinary concrete sidewalk. To the east is the sidewalk, to the west is the end of the sidewalk, and to the north is the bakery.

* * *

>e
sidewalk
An ordinary concrete sidewalk. Seems as if it has been repaved recently. To the west is the west part of the sidewalk, to the east is the east part of the sidewalk, and to the north is the alleyway.

>w
west sidewalk
An ordinary concrete sidewalk. To the east is the sidewalk, to the west is the end of the sidewalk, and to the north is the bakery.

>w
You take a couple steps, but decide there is nothing important this way and turn back.

* * *

>n
jewelry store
A fancy store with glass casing covering all the jewelry. There is no store entrance window, probably so thieves cannot case the inside of the building. To the south is the corner sidewalk.

You can see jeweler here.

>s
corner sidewalk
An ordinary concrete sidewalk. The sidewalk leads to a crosswalk. To the west is the east sidewalk, to the north is the jewlery store, and to the south is the crosswalk.

* * *

>e
You take a couple steps, but decide there is nothing important this way and turn back.

>w
east sidewalk
An ordinary concrete sidewalk. To the west is the sidewalk, to the east is the corner sidewalk, and to the north is the flower shop.

* * *

>w
You take a couple steps, but decide there is nothing important this way and turn back.

>w
You take a couple steps, but decide there is nothing important this way and turn back.

>n
bakery
As you enter the bakery you smell the aroma of fresh bread and see the baker kneading some dough. A glass window is in the front of the store and there is a showcase of different breads in the back of the bakery. There are also other pastries in rows in the storefront window. To the south is the west sidewalk.

You can see baker here.

>ask baker about murder
There is no reply.

>ask baker about killer
There is no reply.

>x
(stamp card)
A stamp card with lots of holes punched in it.

>ask baker about stamp card
Yea, those are my stamp cards, buy 10 loafs get one for free. I remember seeing Lisa come into my shop a couple of hours ago to pre order a loaf of bread with one of those stamp cards. Then she said she was going to go to the flower shop, which is just east of here. She never came back for her bread though, would you like it?

>ask baker about lisa
Please answer yes or no.

>yes
Here you go.

>ask baker about lisa
I heard about her death, she had so much to live for.

>i
You are carrying:
  bread
  stamp card

>s
west sidewalk
An ordinary concrete sidewalk. To the east is the sidewalk, to the west is the end of the sidewalk, and to the north is the bakery.

* * *

>e
east sidewalk
An ordinary concrete sidewalk. To the west is the sidewalk, to the east is the corner sidewalk, and to the north is the flower shop.

>n
flower shop
There are many different types of flowers in here. The aroma from the flowers give you the feeling of a fresh new beginning. You see all kinds of different flowers, like tulips and roses. To the south is the east sidewalk.

You can see florist here.

>x florist
A lady wearing a green apron with a long sleeved shirt, jeans, and glasses. You can ask her about the dead body, Lisa, bakery, jewelry store, and some other things.

>ask lady about dead body
You can't see any such thing.

>ask florist abut dead bosy
I didn't understand that sentence.

>ask florist about dead body
I saw the crime tape while on my way to work today. What a horrible thing to happen in our neighborhood.

>ask florist about jewelry store
That store is right next to this shop, east of here.

>ask florist about bakery
The bakery is west of here, past the alleyway.

>give bread to florist
Florist doesn't seem interested.

>s
east sidewalk
An ordinary concrete sidewalk. To the west is the sidewalk, to the east is the corner sidewalk, and to the north is the flower shop.

* * *

>s
night club entrance
A part of the sidewalk with velvet rope leading into the night club. To the west is the apartment building entrance. To the north is the crosswalk.

You can see bouncer here.

>x bouncer
A tall burly man in a black suit. He looks scary. You can ask him about how to get into the night club, the dead body, Lisa, the apartment building, and a few other things.

>ask bouncer about night club
There is no reply.

>ask bouncer about getting in to the night club
There is no reply.

>ask bouncer how to get in to the night club
I didn't understand that sentence.

>ask bouncer about how to get in to the night club
There is no reply.

>ask bouncer about how to get in to night club
There is no reply.

>ask bouncer about dead body
I heard about the dead body in the alleyway. I wonder who would do such a thing.

>give bouncer bread
Thank you for the bread. I am really hungry right now, but I have to guard this entrance, so I was not able to get any food. You are a real lifesaver.

>i
You are carrying:
  stamp card

>s
The bouncer blocks your path. He seems kind of sad, maybe you could give him some things to cheer him up, so he will let you pass. Maybe something to eat and something that smells nice.

* * *

>n
flower shop
There are many different types of flowers in here. The aroma from the flowers give you the feeling of a fresh new beginning. You see all kinds of different flowers, like tulips and roses. To the south is the east sidewalk.

You can see florist here.

>take flowers
You can't see any such thing.

>take flower
You can't see any such thing.

>take tulip
You can't see any such thing.

I beg your pardon?

>take rose
You can't see any such thing.

I beg your pardon?

>n
You can't go that way.

>s
east sidewalk
An ordinary concrete sidewalk. To the west is the sidewalk, to the east is the corner sidewalk, and to the north is the flower shop.

* * *

>n
bakery
As you enter the bakery you smell the aroma of fresh bread and see the baker kneading some dough. A glass window is in the front of the store and there is a showcase of different breads in the back of the bakery. There are also other pastries in rows in the storefront window. To the south is the west sidewalk.

You can see baker here.

>examine pastries
You can't see any such thing.

>x pastry
You can't see any such thing.

>x pastries
You can't see any such thing.

>l
bakery
As you enter the bakery you smell the aroma of fresh bread and see the baker kneading some dough. A glass window is in the front of the store and there is a showcase of different breads in the back of the bakery. There are also other pastries in rows in the storefront window. To the south is the west sidewalk.

You can see baker here.

>x pastries
You can't see any such thing.

>x pastry
You can't see any such thing.

* * *

>take stamp
Taken.

>x stamp
You see nothing special about stamp card.

* * *

>x body
A blonde woman, maybe in her late 20"s.

you see that she is carrying a stamp card from the bakery next door.

>take stamp card
Taken.

>w
You can't go that way.

* * *

>w
You take a couple steps, but decide there is nothing important this way and turn back.

>e
sidewalk
An ordinary concrete sidewalk. Seems as if it has been repaved recently. To the west is the west part of the sidewalk to the east is the east part of the sidewalk, and to the north is the alleyway.

* * *

>s
The bouncer blocks your path. He seems kind of sad, maybe you could give him some things to cheer him up, so he will let you pass. Maybe something to eat and something that smells nice.

>give bouncer bread
Thank you for the bread. I am really hungry right now, but I have to guard this entrance, so I was not able to get any food. You are a real lifesaver.

* * *

>s
You can't go that way.

>i
You are carrying:
  stamp card

>s
You can't go that way.

>x bar
A marble bar supported by a slab of wood. On one side there is a row of chairs, on the other side you see shelves.

* * *

>x shelves
A row of shelves with liquor on them.

You notice something glimmer behind one of the liquor bottles and move it. You find a key and decide to put it in your pocket.

>i
You are carrying:
  key
  stamp card

>w
You can't go that way.

>n
night club entrance
A part of the sidewalk with velvet rope leading into the night club. To the west is the apartment building entrance. To the north is the crosswalk.

You can see bouncer here.

* * *

>n
jewelry store
You can see jeweler here.

>ask jeweler about dead body
I don't have to talk to you. If you are not a customer I do not want you in my store. Please leave.

>w
You can't go that way.

>s
corner sidewalk
An ordinary concrete sidewalk. The sidewalk leads to a crosswalk. To the west is the east sidewalk, to the north is the jewlery store, and to the south is the crosswalk.

* * *

>w
east sidewalk
An ordinary concrete sidewalk. To the west is the sidewalk, to the east is the corner sidewalk, and to the north is the flower shop.

>w
sidewalk
An ordinary concrete sidewalk. Seems as if it has been repaved recently. To the west is the west part of the sidewalk to the east is the east part of the sidewalk, and to the north is the alleyway.

>s
You can't go that way.

>n
alleyway
A big alley with gray brick walls on either side. The ground has a lot of cracks in the concrete. This is not the type of place you want to be spending your afternoon. To the south is the sidewalk.

You can see your partner and a dead body here.

>i
You are carrying:
  key
  stamp card

>s
sidewalk
An ordinary concrete sidewalk. Seems as if it has been repaved recently. To the west is the west part of the sidewalk to the east is the east part of the sidewalk, and to the north is the alleyway.

>e
You feel like you should still look around here for more clues.

>w
west sidewalk
An ordinary concrete sidewalk. To the east is the sidewalk, to the west is the end of the sidewalk, and to the north is the bakery.

* * *

>e
sidewalk
An ordinary concrete sidewalk. Seems as if it has been repaved recently. To the west is the west part of the sidewalk to the east is the east part of the sidewalk, and to the north is the alleyway.

>e
You feel like you should still look around here for more clues.

>n
alleyway
A big alley with gray brick walls on either side. The ground has a lot of cracks in the concrete. This is not the type of place you want to be spending your afternoon. To the south is the sidewalk.

You can see your partner and a dead body here.

>ask florist about flowers
You can't see any such thing.

>i
You are carrying:
  key
  stamp card

* * *

>s
sidewalk
An ordinary concrete sidewalk. Seems as if it has been repaved recently. To the west is the west part of the sidewalk to the east is the east part of the sidewalk, and to the north is the alleyway.

>s
You can't go that way.

>e
You feel like you should still look around here for more clues.

>i
You are carrying:
  key
  stamp card

>w
west sidewalk
An ordinary concrete sidewalk. To the east is the sidewalk, to the west is the end of the sidewalk, and to the north is the bakery.

* * *

>w
You take a couple steps, but decide there is nothing important this way and turn back.

>n
bakery
As you enter the bakery you smell the aroma of fresh bread and see the baker kneading some dough.

You can see baker here.

>ask baker about stamp card
Yea, those are my stamp cards, buy 10 loafs get one for free. I remember seeing Lisa come into my shop a couple of hours ago to pre order a loaf of bread with one of those stamp cards. Then she said she was going to go to the flower shop, which is just east of here. She never came back for her bread though, would you like it?

* * *

>yes
Here you go.

>n
You can't go that way.

* * *

>e
corner sidewalk
An ordinary concrete sidewalk. The sidewalk leads to a crosswalk. To the west is the east sidewalk, to the north is the jewlery store, and to the south is the crosswalk.

>i
You are carrying:
  bread
  key
  stamp card

>w
east sidewalk
An ordinary concrete sidewalk. To the west is the sidewalk, to the east is the corner sidewalk, and to the north is the flower shop.

* * *

>n
jewelry store
You can see jeweler here.

>ask jeweler about jewels
There is no reply.

>w
You can't go that way.

* * *

>x bar
A marble bar supported by a slab of wood. On one side there is a row of chairs, on the other side you see shelves.

>xshelves
That's not a verb I recognise.

>x shelves
A row of shelves with liquor on them.

You notice something glimmer behind one of the liquor bottles and move it. You find a key and decide to put it in your pocket.

* * *

>i
You are carrying:
  key
  stamp card

>s
You can't go that way.

* * *

>n
crosswalk
A white and black striped crosswalk.

>s
night club entrance
A part of the sidewalk with velvet rope leading into the night club. To the west is the apartment building entrance. To the north is the crosswalk.

You can see bouncer here.

* * *

>s
(first opening apartment entrance door)
It seems to be locked.

>s
(first opening apartment entrance door)
It seems to be locked.

>x key
An ordinary key that unlocks a door. It has a number on it, 101.

>open door with key
You unlock apartment entrance door.

>open apartment entrance door with key
You can't see any such thing.

>unlock apartment entrance door with key
You can't see any such thing.

>unlock popcorn with key
That's unlocked at the moment.

>s
(first opening apartment entrance door)

apartment building
An apartment with no security. There is a hall with rooms on either side. To the north is the apartment entrance. To the west is room 101.

You can see apartment entrance door here.

>n
apartment building entrance
A one-story building stands before you. To the south is the door to the apartment building. To the east is the night club entrance.

You can see apartment entrance door here.

>n
You can't go that way.

* * *

>w
You can't go that way.

>e
night club entrance
A part of the sidewalk with velvet rope leading into the night club. To the west is the apartment building entrance. To the north is the crosswalk.

You can see bouncer here.

* * *

>s
night club
Since it is not night, there is no one in the night club at the moment. You see a bar and a row of seats. To the north is the night club entrance.

You can see a bar here.

>n
night club entrance
A part of the sidewalk with velvet rope leading into the night club. To the west is the apartment building entrance. To the north is the crosswalk.

You can see bouncer here.

* * *

>w
apartment building entrance
A one-story building stands before you. To the south is the door to the apartment building. To the east is the night club entrance.

You can see apartment entrance door here.

>s
apartment building
An apartment with no security. There is a hall with rooms on either side. To the north is the apartment entrance. To the west is room 101.

You can see apartment entrance door here.

>west
You jiggle the door knob and realize that the door is unlocked.

>west
You jiggle the door knob and realize that the door is unlocked.

* * *

>x dead
A blonde woman, maybe in her late 20"s.

you see that she is carrying a stamp card from the bakery next door.

* * *

>x dead body
A blonde woman, maybe in her late 20"s.

you see that she is carrying a stamp card from the bakery next door.

>i
You are carrying:
  stamp card

>s
sidewalk
An ordinary concrete sidewalk. Seems as if it has been repaved recently. To the west is the west part of the sidewalk to the east is the east part of the sidewalk, and to the north is the alleyway.

* * *

>w
end of sidewalk
An ordinary concrete sidewalk. Thee is no reason to walk further west.

>s
You can't go that way.

>n
abandoned building

* * *

>s
end of sidewalk
An ordinary concrete sidewalk. Thee is no reason to walk further west.

>e
west sidewalk
An ordinary concrete sidewalk. To the east is the sidewalk, to the west is the end of the sidewalk, and to the north is the bakery.

>n
bakery
As you enter the bakery you smell the aroma of fresh bread and see the baker kneading some dough.

You can see baker here.

>take all
There are none at all available!

>ask baker about loaf of bread
There is no reply.

>ask baker about stamp
I remember seeing her come into my shop a couple of hours ago to pre order a loaf of bread. Then she said she was on her way to the flower shop, which is just east of here. She never came back for her bread though, would you like it?

>ask baker about stamp card
I remember seeing her come into my shop a couple of hours ago to pre order a loaf of bread. Then she said she was on her way to the flower shop, which is just east of here. She never came back for her bread though, would you like it?

>ask baker about stamp
I remember seeing her come into my shop a couple of hours ago to pre order a loaf of bread. Then she said she was on her way to the flower shop, which is just east of here. She never came back for her bread though, would you like it?

* * *

>x dead body
A blonde woman, maybe in her late 20"s.

you see that she is carrying a stamp card from the bakery next door.

>s
sidewalk
An ordinary concrete sidewalk. Seems as if it has been repaved recently. To the west is the west part of the sidewalk to the east is the east part of the sidewalk, and to the north is the alleyway.

>w
west sidewalk
An ordinary concrete sidewalk. To the east is the sidewalk, to the west is the end of the sidewalk, and to the south is the bakery.

>n
bakery
As you enter the bakery you smell the aroma of fresh bread and see the baker kneading some dough.

You can see baker here.

>talk to baker
That's not a verb I recognise.

>s
west sidewalk
An ordinary concrete sidewalk. To the east is the sidewalk, to the west is the end of the sidewalk, and to the south is the bakery.

>e
sidewalk
An ordinary concrete sidewalk. Seems as if it has been repaved recently. To the west is the west part of the sidewalk to the east is the east part of the sidewalk, and to the north is the alleyway.

* * *

>ask florist about flower
Sure, I have lots of flowers, I'll give you one for free.

>w
You can't go that way.

>s
east sidewalk
An ordinary concrete sidewalk. To the west is the sidewalk, to the east is the corner sidewalk, and to the north is the flower shop.

* * *

>x bar
A marble bar supported by a slab of wood. On one side there is a row of chairs, on the other side you see shelves.

>x shelves
You notice something glimmer behind one of the liquor bottles and move it. You find a key and decide to put it in your pocket.

>x shelves
A row of shelves with liquor on them.

* * *

>take stamp
Taken.

>x stamp
A stamp card with lots of holes punched in it.

>west
You can't go that way.

>s
sidewalk
An ordinary concrete sidewalk. Seems as if it has been repaved recently. To the west is the west part of the sidewalk to the east is the east part of the sidewalk, and to the north is the alleyway.

* * *

>s
night club entrance
You can see bouncer here.

>s
The bouncer blocks your path

>x 'night club'
You can't see any such thing.

>x bar
You can't see any such thing.

>x shelves
You can't see any such thing.

>take key
You can't see any such thing.

>i
You are carrying:
  bread
  stamp card

>n
crosswalk
A white and black striped crosswalk.

* * *

>ask florist about flower
Sure, I have lots of flowers, I'll give you one for free.

>i
You are carrying:
  flower
  bread
  stamp card

>w
You can't go that way.

* * *

>e
corner sidewalk
An ordinary concrete sidewalk. The sidewalk leads to a crosswalk. To the west is the east sidewalk, to the north is the jewlery store, and to the south is the crosswalk.

>e
You can't go that way.

>s
crosswalk
A white and black striped crosswalk.

* * *

>s
The bouncer blocks your path

>nn
That's not a verb I recognise.

>n
crosswalk
A white and black striped crosswalk.

* * *

>w
You take a couple steps, but decide there is nothing important this way and turn back.

>i
You are carrying:
  flower
  bread
  stamp card

>e
sidewalk
An ordinary concrete sidewalk. Seems as if it has been repaved recently. To the west is the west part of the sidewalk to the east is the east part of the sidewalk, and to the north is the alleyway.

* * *

>x dead body
A blonde woman, maybe in her late 20"s.

you see that she is carrying a stamp card from the bakery next door.

>x bread
whole wheat bread, it looks a little smashed.

>take bread
Taken.

>eat bread
That's plainly inedible.

* * *

>x victim
A blonde woman, maybe in her late 20"s.

you see that she is carrying a stamp card from the bakery next door.

>pick up victim
That's fixed in place.